22222222222222222222222222222
20000000000000000000002000002
20000000000000000000000000002
20022020000000000000020000202
20002020000000000000050002202
20000000000004000002222220202
20100003000222222000000000002
20002222220000000000000000002
22222222222222222222222222222
