222222222222222222222222222222
200000000000000000000020000022
200000000002200000000000000022
200220200002200000000200002022
200020200000000000000500022022
200000000000040000022222202022
201000330002222220000000000022
200022222200000000000000000022
222222222222222222222222222222
222222222222222222222222222222
222222222222222222222222222222
222222222222222222222222222222