22222222222222222222222222222222222222
20000000000000000000000000000000000022
20022022222222200000000000000220000022
20002220222002222000000000000200000022
20000000000000000000002000002200000022
20000000000220222200000000000000022022
20022020000220222200020000200000022022
20002020000000000000050002202200022022
20000000000004000002222220202200000022
20100033000222222000000000002200000022
20002222220000000000000000002200000222
22222222222222222222222222222200022222
22222222222222222222222222222200022222
22222222222222222222222222222200222222
22222222222222222222222222222222222222