22222222222222222222222222222
20000000000000000000000000002
20000000000000000000000000002
20000000000000000000000000002
20000000000000000000050000002
20000000000004000002222220002
20100003000222222000000000002
20002222220000000000000000002
22222222222222222222222222222
